111111
1EPC01
111111
111111
1EPC01
111111
1EPC01
111111
